R 500 500
NO ./texture/north.xpm
EA ./texture/east.xpm
WE ./texture/west.xpm
SO ./texture/south.xpm
S ./texture/lag_star.xpm
C 255,186,8
F 50,1,19

11111111111111111
10000000000000011
10000000020000111
100000S0000000311
1000000000000011
1000000000000011
1111111111111111