R 1000 800
WE ./texture/west.xpm
SO ./texture/south.xpm
NO ./texture/north.xpm
EA ./texture/east.xpm
C 255,186,8
F 50,1,19

111111111111111111111111
100000000000000000000001
100000000000000000000001
100000000000000000000001
100000000000000000000001
1000000000E0001000000001
100000000000200000000001
100000000000000000000001
100000002000000000000001
100000000000000000000001
111111111111111111111111