R 1500 1000
NO ./texture/north.xpm
EA ./texture/east.xpm
WE ./texture/west.xpm
SO ./texture/south.xpm
S ./texture/sprite.xpm
C 255,186,8
F 50,1,19

111111111
100000001
100000001
100000001
100000001
100030001
100000001
100000001
100000001
100000001
100000001
100000001
100000001
100000001
100000001
100000001
1000N0001
111111111