R 1000 1000
NO ./texture/north.xpm
EA ./texture/east.xpm
WE ./texture/west.xpm
SO ./texture/south.xpm
S ./texture/lag_star.xpm
C 255,186,8
F 50,1,19

11111111333333111111111111
10000001000000000000000001
10000000000200000000000001
10000000000000000000000001
10000000000S00000000000001
10000000000000000000000001
10000000000000000000000001
10000000000000000000000001
10000000000000000000000001
10000000000000000000000001
10000000000000000000000001
11111111111111111111111111