R 1000 800
NO ./texture/north.xpm
EA ./texture/east.xpm
WE ./texture/west.xpm
SO ./texture/south.xpm
S ./texture/sprite.xpm
C 255,186,8
F 50,1,19

11111111111111111111111111
10000000000000000000000003
10000000000000000000000003
10000000002000000000000003
10000000000000000000000003
1000000000N000000000000003
10000000000000000000000003
10000000000000000000000003
10000000000000000000000003
10000000000000000000000003
10000000000000000000000003
11111111111111111111111111