R 800 1000
NO ./texture/north.xpm
EA ./texture/east.xpm
WE ./texture/west.xpm
SO ./texture/south.xpm
S ./texture/lag_star.xpm
C 255,186,8
F 50,1,19

11111111111111111111111111
10000001000000000000000001
100000000002000000000000011
100000000000000000000000001
10000000000S000000000000001
100000000000000000000000011
10000000000000000000000001       111
10000000000000000000000001       1311
10000000000000000000000001       1011
1000000000000000000000000111111111011
1000000000000000000000000000000000031
1111111111111111111111111111111111111