R 800 500
NO ./texture/north.xpm
EA ./texture/east.xpm
WE ./texture/west.xpm
SO ./texture/south.xpm
S ./texture/lag_star.xpm
C 255,186,8
F 50,1,19

11111111333333111111111111
10000000000000000000000001
10000000000000000000000001
10000000020000000000000001
10000000000000000020002001
10000000000000000000200001
1000000000N000000000000001
10000000000000002000000001
10000000000000000000000001
10000000000000000000000001
10000000000002222222222221
11111111111111111111111111