R 500 500
NO ./texture/north.xpm
EA ./texture/east.xpm
WE ./texture/west.xpm
SO ./texture/south.xpm
S ./texture/lag_star.xpm
C 255,186,8
F 50,1,19

111111111111111111
111111333333111111
110000000000000011
110000000020000011
1100000S0000000011
110000000000000011
110000000000000011
111111111111111111
111111111111111111