R 500 500
NO ./texture/north.xpm
EA ./texture/east.xpm
WE ./texture/west.xpm
SO ./texture/south.xpm
S ./texture/south_crackd.xpm
C 255,186,8
F 50,1,19

1111111111111111111111111111111111111111111111111111111111111111111
1E02000000100001000111111111110000000000000000000000000000000000201
1111111110100101010100000000010111111111111111111111111111111111111
1111111110100101110100000000010000000000000000000000000000000000001
1000000000100100000100000000010000000000000000000000000000000000001
1011111110100101110100011100010000000000000000000000000000000000001
1010000010111101010100010100010001111111110001111111111111111110001
1011111010000001010100010100010001000000010001000000000010000010001
1000001110111111010100011111110001111000010001000000000010000010001
1111111110110000010100000000000000001000010001000000000010000010001
1000000000110111010100000000000000001000010001000000000010000010001
1111111111110111000100000000000000001000010001000000000011111110001
1111111111112111111100011111111110001000000001000000000000000000001
1000000200100010000100011110000010001000000001000000000000000000001
1000000200100010001100011110000010001000000001000000000000000000001
1011111111100011111100011110000010001111111111111111110001111111111
1000000000000000000000010000000010001000000000000000000000000000001
1000000000000000000000010000000010001000000000000000000000000000001
1000000000000000000000010001111110001111111111111111111111111111111
1000111111100011111100010001000000000000000000000000000000000000001
1000100000100010000100010001000000000000000000000000000000000000001
1000100000100010000100010001000000000000000000000000000000000000001
1000100000100011111100010001000000000000000000000000000000000000001
1000111111100000000000010001000000000000000000000000000000000000001
1000000000000000000000010001000000000000000000000000000000000000001
1000000000000000000000010001000000000000000000000000000000000000001
1000000000000000000000011111111111111111133333333333333311111111111
1111111111111111111111111111111111111111111111111111111111111111111