R 500 500
NO ./texture/shrek/shrek1.xpm
EA ./texture/shrek/shrek2.xpm
WE ./texture/shrek/shrek3.xpm
SO ./texture/shrek/shrek4.xpm
S ./texture/lag_star.xpm
C 255,186,8
F 50,1,19

111111111111111111
111111111111111111
110000000000000011
110000000000000011
1100000S0000000011
110000000000000011
110000000000000011
111111111111111111
111111111111111111