R 500 500
NO ./texture/north.xpm


EA ./texture/east.xpm

WE ./texture/west.xpm
SO ./texture/south.xpm


S ./texture/lag_star.xpm
C 255  ,     186   ,      8
F 50  ,    1  ,     19

111111111111111
100000000000001
1000000002000011
10000000000000W1
1000000000000011
100000000000001
111111111111111